###.........
#0XXXXXXXXG.
#...........
............
............
............
............
............
............
............
............
............