###.........
#OXXXXXXXXG.
#...........
............
............
............
............
............
............
............
............
............